Implemented look (in xml) :
Clay			Default look
Straw			100 Farm
All worker and slave	Need their living counterpart *100.



Possible new look : 

Porcelain		Milking parlor
Rag doll		Animal Barn
Wood			Factory
Plastic			Warehouse
Wax				Business center
leather			Slave Barn

Glass			Clinic
Marble			Temple

Steel			Science Lab
Gold			Alchemy Tower

Robot			Secret Lab
Puppet			Witchcraft tower

Slime			Astroport
Fairy			Portal

Rubis			Science Barn
Saphir			Magic Barn

Onix			Dark energy condenser
Daimond			Prism


Honey Slime		Astroport + Witchcraft tower
Choco Fairy		Secret Lab + Portal
Cookie			Honey Slime + Choco Fairy


Ultimate Robot Milker	Ultimate machine +
			 Clinic, Science Lab, Secret Lab, Astroport & Dark energy condenser
Tentacle Goddess		Tentacle Queen +
			Temple, Alchemy tower, Witchcraft tower, Portal & Prism